{
    "levelMap": [
    [1, 1, 1, 1, 1, 1, 1, 1],
    [1, 7, 0, 8, 0, 9, 0, 1],
    [1, 1, 0, 1, 0, 1, 0, 1],
    [1, 9, 0, 9, 7, 0, 8, 1],
    [1, 1, 0, 1, 1, 0, 1, 1],
    [1, 7, 0, 7, 8, 0, 8, 1],
    [1, 1, 1, 1, 1, 1, 1, 1]
]
}